HHXHDDDGDP
HHDSDDDDDP
ADSDDDSSHH
DDDDDHSSHX
DDDPPPDDDD
DDDDHHHHDP
DDGHHHHHDG
